%%%%%%%%%%%%%%%%%%%%%%%%%%%%%%%%%
%                               %
%        %%%%%%                 %
%      %%             %%%%%%% %%%
%     %             %%          %
%     %            %%           %
%    %             %         P  %
%    %            %%            %
% . %            %%             %
%    %            %%            %
%    %             %            %
%     %            %%           %
%     %             %           %
%      %            %%          %
%      %              %%%%%%%%%%%
%       %                       %
%       %                       %
%       %                       %
%       %                       %
%%%%%%%%%%%%%%%%%%%%%%%%%%%%%%%%%