%%%%%%%%%
%.  %.. %
% % %%% %
% % .  .%
% %%P%% %
%. ..  .%
% % %%%%%
%. .  ..%
%%%%%%%%%